,chromosome,start,end,who tf knows,length,strand
0,chr1,36931667,36931924,chr1:36931667:36931924:195295220,257,-
1,chr1,36931867,36932130,chr1:36931867:36932130:195295221,263,+
2,chr1,36932077,36932334,chr1:36932077:36932334:195295222,257,-
3,chr1,36932283,36932550,chr1:36932283:36932550:195295223,267,+
4,chr1,36932800,36933069,chr1:36932800:36933069:195295224,269,-
5,chr1,36933016,36933286,chr1:36933016:36933286:195295225,270,+
6,chr1,36933234,36933488,chr1:36933234:36933488:195295226,254,-
7,chr1,36933432,36933697,chr1:36933432:36933697:195295227,265,+
8,chr1,36934724,36934971,chr1:36934724:36934971:195295228,247,-
9,chr1,36939009,36939279,chr1:36939009:36939279:195295229,270,-
10,chr1,43814899,43815125,chr1:43814899:43815125:195295277,226,-
11,chr1,115252159,115252406,chr1:115252159:115252406:195295594,247,-
12,chr1,115256390,115256650,chr1:115256390:115256650:195295595,260,-
13,chr1,115258642,115258903,chr1:115258642:115258903:195295596,261,-
14,chr11,533735,533964,chr11:533735:533964:195294829,229,-
15,chr11,533913,534140,chr11:533913:534140:195294830,227,+
16,chr11,534089,534333,chr11:534089:534333:195294831,244,-
17,chr11,534279,534521,chr11:534279:534521:195294832,242,+
18,chr11,32410577,32410842,chr11:32410577:32410842:195295191,265,-
19,chr11,32413485,32413750,chr11:32413485:32413750:195295192,265,-
20,chr11,32414183,32414411,chr11:32414183:32414411:195295193,228,-
21,chr11,32417770,32418019,chr11:32417770:32418019:195295194,249,-
22,chr11,32449463,32449698,chr11:32449463:32449698:195295195,235,-
23,chr11,32450012,32450276,chr11:32450012:32450276:195295196,264,-
24,chr11,32456205,32456477,chr11:32456205:32456477:195295197,272,-
25,chr11,32456427,32456681,chr11:32456427:32456681:195295198,254,+
26,chr11,32456629,32456896,chr11:32456629:32456896:195295199,267,-
27,chr11,32456841,32457116,chr11:32456841:32457116:195295200,275,+
28,chr11,47376731,47376959,chr11:47376731:47376959:195295365,228,-
29,chr11,47376909,47377173,chr11:47376909:47377173:195295366,264,+
30,chr11,47381373,47381615,chr11:47381373:47381615:195295367,242,-
31,chr11,47381561,47381799,chr11:47381561:47381799:195295368,238,+
32,chr11,118307322,118307582,chr11:118307322:118307582:195295614,260,-
33,chr11,118343067,118343310,chr11:118343067:118343310:195295615,243,-
34,chr11,118348722,118348953,chr11:118348722:118348953:195295616,231,-
35,chr11,118350880,118351133,chr11:118350880:118351133:195295617,253,-
36,chr11,118352429,118352690,chr11:118352429:118352690:195295618,261,-
37,chr11,118353075,118353350,chr11:118353075:118353350:195295619,275,-
38,chr11,118373970,118374233,chr11:118373970:118374233:195295620,263,-
39,chr11,119142412,119142642,chr11:119142412:119142642:195295621,230,-
40,chr11,119148787,119149022,chr11:119148787:119149022:195295622,235,-
41,chr11,119148969,119149234,chr11:119148969:119149234:195295623,265,+
42,chr11,119149181,119149430,chr11:119149181:119149430:195295624,249,-
43,chr11,119149375,119149618,chr11:119149375:119149618:195295625,243,+
44,chr11,119155636,119155873,chr11:119155636:119155873:195295626,237,-
45,chr11,119169035,119169268,chr11:119169035:119169268:195295627,233,-
46,chr11,119169213,119169470,chr11:119169213:119169470:195295628,257,+
47,chr12,11803033,11803276,chr12:11803033:11803276:195294958,243,-
48,chr12,11905351,11905626,chr12:11905351:11905626:195294964,275,-
49,chr12,11992045,11992310,chr12:11992045:11992310:195294965,265,-
50,chr12,12006330,12006593,chr12:12006330:12006593:195294966,263,-
51,chr12,12022329,12022602,chr12:12022329:12022602:195294967,273,-
52,chr12,12022547,12022799,chr12:12022547:12022799:195294968,252,+
53,chr12,12022747,12022976,chr12:12022747:12022976:195294969,229,-
54,chr12,12037350,12037589,chr12:12037350:12037589:195294970,239,-
55,chr12,12038829,12039104,chr12:12038829:12039104:195294971,275,-
56,chr12,12043844,12044099,chr12:12043844:12044099:195294972,255,-
57,chr12,25378515,25378784,chr12:25378515:25378784:195295047,269,-
58,chr12,25380087,25380360,chr12:25380087:25380360:195295048,273,-
59,chr12,25380305,25380580,chr12:25380305:25380580:195295049,275,+
60,chr12,25398173,25398416,chr12:25398173:25398416:195295050,243,-
61,chr12,112884023,112884268,chr12:112884023:112884268:195295587,245,-
62,chr12,112888093,112888326,chr12:112888093:112888326:195295588,233,-
63,chr12,112888271,112888510,chr12:112888271:112888510:195295589,239,+
64,chr12,112910711,112910968,chr12:112910711:112910968:195295590,257,-
65,chr12,112915424,112915681,chr12:112915424:112915681:195295591,257,-
66,chr12,112926220,112926493,chr12:112926220:112926493:195295592,273,-
67,chr12,112926795,112927032,chr12:112926795:112927032:195295593,237,-
68,chr13,28588558,28588833,chr13:28588558:28588833:195295100,275,-
69,chr13,28592571,28592798,chr13:28592571:28592798:195295101,227,-
70,chr13,28598955,28599220,chr13:28598955:28599220:195295102,265,-
71,chr13,28602286,28602559,chr13:28602286:28602559:195295103,273,-
72,chr13,28607886,28608144,chr13:28607886:28608144:195295104,258,-
73,chr13,28608090,28608338,chr13:28608090:28608338:195295105,248,+
74,chr13,28608284,28608541,chr13:28608284:28608541:195295106,257,-
75,chr13,28609601,28609852,chr13:28609601:28609852:195295107,251,-
76,chr13,28609793,28610044,chr13:28609793:28610044:195295108,251,+
77,chr13,28609987,28610214,chr13:28609987:28610214:195295109,227,-
78,chr15,90631790,90632043,chr15:90631790:90632043:195295489,253,-
79,chr16,3777594,3777827,chr16:3777594:3777827:195294833,233,-
80,chr16,3777770,3777997,chr16:3777770:3777997:195294834,227,+
81,chr16,3777940,3778165,chr16:3777940:3778165:195294835,225,-
82,chr16,3778112,3778346,chr16:3778112:3778346:195294836,234,+
83,chr16,3778290,3778515,chr16:3778290:3778515:195294837,225,-
84,chr16,3778456,3778683,chr16:3778456:3778683:195294838,227,+
85,chr16,3778602,3778827,chr16:3778602:3778827:195294839,225,-
86,chr16,3778772,3778997,chr16:3778772:3778997:195294840,225,+
87,chr16,3778946,3779171,chr16:3778946:3779171:195294841,225,-
88,chr16,3779120,3779353,chr16:3779120:3779353:195294842,233,+
89,chr16,3779302,3779574,chr16:3779302:3779574:195294843,272,-
90,chr16,3779520,3779767,chr16:3779520:3779767:195294844,247,+
91,chr16,3779714,3779980,chr16:3779714:3779980:195294845,266,-
92,chr16,3795247,3795486,chr16:3795247:3795486:195294846,239,-
93,chr16,3801698,3801957,chr16:3801698:3801957:195294847,259,-
94,chr16,3807779,3808050,chr16:3807779:3808050:195294848,271,-
95,chr16,3807995,3808226,chr16:3807995:3808226:195294849,231,+
96,chr16,3817688,3817916,chr16:3817688:3817916:195294850,228,-
97,chr16,3817862,3818119,chr16:3817862:3818119:195294851,257,+
98,chr16,3819148,3819397,chr16:3819148:3819397:195294852,249,-
99,chr16,3830702,3830959,chr16:3830702:3830959:195294853,257,-
100,chr16,3832656,3832901,chr16:3832656:3832901:195294854,245,-
101,chr16,3832846,3833113,chr16:3832846:3833113:195294855,267,+
102,chr16,15797807,15798082,chr16:15797807:15798082:195294993,275,-
103,chr16,15810966,15811240,chr16:15810966:15811240:195294996,274,-
104,chr16,15813981,15814244,chr16:15813981:15814244:195294997,263,-
105,chr16,15814659,15814887,chr16:15814659:15814887:195294998,228,-
106,chr16,15814837,15815076,chr16:15814837:15815076:195294999,239,+
107,chr16,15815246,15815515,chr16:15815246:15815515:195295000,269,-
108,chr16,15815462,15815689,chr16:15815462:15815689:195295001,227,+
109,chr16,15835287,15835525,chr16:15835287:15835525:195295009,238,-
110,chr16,15835471,15835700,chr16:15835471:15835700:195295010,229,+
111,chr16,15841702,15841929,chr16:15841702:15841929:195295016,227,-
112,chr16,15872604,15872873,chr16:15872604:15872873:195295017,269,-
113,chr16,15876213,15876470,chr16:15876213:15876470:195295018,257,-
114,chr16,30715352,30715624,chr16:30715352:30715624:195295120,272,-
115,chr16,30715568,30715801,chr16:30715568:30715801:195295121,233,+
116,chr16,30720807,30721079,chr16:30720807:30721079:195295122,272,-
117,chr16,30721025,30721256,chr16:30721025:30721256:195295123,231,+
118,chr16,30721201,30721454,chr16:30721201:30721454:195295124,253,-
119,chr16,30721401,30721640,chr16:30721401:30721640:195295125,239,+
120,chr16,30723959,30724212,chr16:30723959:30724212:195295126,253,-
121,chr16,30727583,30727850,chr16:30727583:30727850:195295127,267,-
122,chr16,30727793,30728026,chr16:30727793:30728026:195295128,233,+
123,chr16,30732479,30732707,chr16:30732479:30732707:195295129,228,-
124,chr16,30732659,30732890,chr16:30732659:30732890:195295130,231,+
125,chr16,30734255,30734518,chr16:30734255:30734518:195295131,263,-
126,chr16,30734467,30734740,chr16:30734467:30734740:195295132,273,+
127,chr16,30734778,30735004,chr16:30734778:30735004:195295133,226,-
128,chr16,30734926,30735151,chr16:30734926:30735151:195295134,225,+
129,chr16,30735076,30735303,chr16:30735076:30735303:195295135,227,-
130,chr16,30735226,30735451,chr16:30735226:30735451:195295136,225,+
131,chr16,30735382,30735607,chr16:30735382:30735607:195295137,225,-
132,chr16,30735530,30735755,chr16:30735530:30735755:195295138,225,+
133,chr16,30735682,30735907,chr16:30735682:30735907:195295139,225,-
134,chr16,30735828,30736099,chr16:30735828:30736099:195295140,271,+
135,chr16,30736046,30736303,chr16:30736046:30736303:195295141,257,-
136,chr16,30736248,30736495,chr16:30736248:30736495:195295142,247,+
137,chr16,30740256,30740511,chr16:30740256:30740511:195295143,255,-
138,chr16,30740462,30740706,chr16:30740462:30740706:195295144,244,+
139,chr16,30740650,30740879,chr16:30740650:30740879:195295145,229,-
140,chr16,30740824,30741055,chr16:30740824:30741055:195295146,231,+
141,chr16,30747488,30747757,chr16:30747488:30747757:195295147,269,-
142,chr16,30748239,30748475,chr16:30748239:30748475:195295148,236,-
143,chr16,30748395,30748621,chr16:30748395:30748621:195295149,226,+
144,chr16,30748563,30748790,chr16:30748563:30748790:195295150,227,-
145,chr16,30748709,30748934,chr16:30748709:30748934:195295151,225,+
146,chr16,30748849,30749075,chr16:30748849:30749075:195295152,226,-
147,chr16,30748995,30749221,chr16:30748995:30749221:195295153,226,+
148,chr16,30749141,30749367,chr16:30749141:30749367:195295154,226,-
149,chr16,30749317,30749542,chr16:30749317:30749542:195295155,225,+
150,chr16,30749459,30749687,chr16:30749459:30749687:195295156,228,-
151,chr16,30749601,30749826,chr16:30749601:30749826:195295157,225,+
152,chr16,30749749,30749977,chr16:30749749:30749977:195295158,228,-
153,chr16,30749913,30750139,chr16:30749913:30750139:195295159,226,+
154,chr16,30750061,30750287,chr16:30750061:30750287:195295160,226,-
155,chr16,30750209,30750435,chr16:30750209:30750435:195295161,226,+
156,chr16,30750387,30750615,chr16:30750387:30750615:195295162,228,-
157,chr16,30750561,30750805,chr16:30750561:30750805:195295163,244,+
158,chr16,30750753,30751027,chr16:30750753:30751027:195295164,274,-
159,chr16,30750977,30751240,chr16:30750977:30751240:195295165,263,+
160,chr17,7572892,7573131,chr17:7572892:7573131:195294871,239,-
161,chr17,7573896,7574141,chr17:7573896:7574141:195294872,245,-
162,chr17,7576496,7576766,chr17:7576496:7576766:195294873,270,-
163,chr17,7576716,7576988,chr17:7576716:7576988:195294874,272,+
164,chr17,7576934,7577193,chr17:7576934:7577193:195294875,259,-
165,chr17,7577138,7577403,chr17:7577138:7577403:195294876,265,+
166,chr17,7577458,7577683,chr17:7577458:7577683:195294877,225,-
167,chr17,7578144,7578394,chr17:7578144:7578394:195294878,250,-
168,chr17,7578344,7578619,chr17:7578344:7578619:195294879,275,+
169,chr17,7579281,7579548,chr17:7579281:7579548:195294880,267,-
170,chr17,7579493,7579766,chr17:7579493:7579766:195294881,273,+
171,chr17,7579711,7579978,chr17:7579711:7579978:195294882,267,-
172,chr17,7637757,7637989,chr17:7637757:7637989:195294883,232,-
173,chr17,7637937,7638182,chr17:7637937:7638182:195294884,245,+
174,chr17,7667404,7667632,chr17:7667404:7667632:195294885,228,-
175,chr17,7669607,7669839,chr17:7669607:7669839:195294886,232,-
176,chr17,7673846,7674113,chr17:7673846:7674113:195294887,267,-
177,chr17,7674058,7674307,chr17:7674058:7674307:195294888,249,+
178,chr17,7680735,7680998,chr17:7680735:7680998:195294889,263,-
179,chr17,7681567,7681834,chr17:7681567:7681834:195294890,267,-
180,chr17,7682534,7682805,chr17:7682534:7682805:195294891,271,-
181,chr17,7683919,7684178,chr17:7683919:7684178:195294892,259,-
182,chr17,7689415,7689685,chr17:7689415:7689685:195294893,270,-
183,chr17,7689629,7689904,chr17:7689629:7689904:195294894,275,+
184,chr17,7697539,7697790,chr17:7697539:7697790:195294895,251,-
185,chr17,7721081,7721307,chr17:7721081:7721307:195294896,226,-
186,chr17,7721255,7721513,chr17:7721255:7721513:195294897,258,+
187,chr17,7722208,7722441,chr17:7722208:7722441:195294898,233,-
188,chr17,7727410,7727685,chr17:7727410:7727685:195294899,275,-
189,chr17,7727632,7727867,chr17:7727632:7727867:195294900,235,+
190,chr17,7727812,7728044,chr17:7727812:7728044:195294901,232,-
191,chr17,7727990,7728247,chr17:7727990:7728247:195294902,257,+
192,chr17,7734373,7734599,chr17:7734373:7734599:195294903,226,-
193,chr17,7734545,7734784,chr17:7734545:7734784:195294904,239,+
194,chr17,10347890,10348145,chr17:10347890:10348145:195294905,255,-
195,chr17,10351104,10351379,chr17:10351104:10351379:195294906,275,-
196,chr17,10351324,10351579,chr17:10351324:10351579:195294907,255,+
197,chr17,10352154,10352391,chr17:10352154:10352391:195294908,237,-
198,chr17,10353735,10353963,chr17:10353735:10353963:195294909,228,-
199,chr17,10353911,10354136,chr17:10353911:10354136:195294910,225,+
200,chr17,10354081,10354344,chr17:10354081:10354344:195294911,263,-
201,chr17,10355227,10355475,chr17:10355227:10355475:195294912,248,-
202,chr17,10355425,10355699,chr17:10355425:10355699:195294913,274,+
203,chr17,10355641,10355880,chr17:10355641:10355880:195294914,239,-
204,chr17,10366085,10366354,chr17:10366085:10366354:195294915,269,-
205,chr17,10366829,10367070,chr17:10366829:10367070:195294916,241,-
206,chr17,10367758,10368029,chr17:10367758:10368029:195294917,271,-
207,chr17,10427754,10428029,chr17:10427754:10428029:195294918,275,-
208,chr17,10429883,10430144,chr17:10429883:10430144:195294919,261,-
209,chr17,10431974,10432224,chr17:10431974:10432224:195294920,250,-
210,chr17,10432174,10432419,chr17:10432174:10432419:195294921,245,+
211,chr17,10432366,10432635,chr17:10432366:10432635:195294922,269,-
212,chr17,10432580,10432841,chr17:10432580:10432841:195294923,261,+
213,chr17,10438357,10438616,chr17:10438357:10438616:195294924,259,-
214,chr17,10443214,10443463,chr17:10443214:10443463:195294925,249,-
215,chr17,10451007,10451265,chr17:10451007:10451265:195294926,258,-
216,chr17,10451211,10451460,chr17:10451211:10451460:195294927,249,+
217,chr17,11501781,11502007,chr17:11501781:11502007:195294928,226,-
218,chr17,11501953,11502227,chr17:11501953:11502227:195294929,274,+
219,chr17,11502175,11502434,chr17:11502175:11502434:195294930,259,-
220,chr17,11513680,11513943,chr17:11513680:11513943:195294931,263,-
221,chr17,11522832,11523057,chr17:11522832:11523057:195294932,225,-
222,chr17,11523002,11523229,chr17:11523002:11523229:195294933,227,+
223,chr17,11543558,11543817,chr17:11543558:11543817:195294934,259,-
224,chr17,11550358,11550587,chr17:11550358:11550587:195294935,229,-
225,chr17,11556045,11556302,chr17:11556045:11556302:195294936,257,-
226,chr17,11556247,11556504,chr17:11556247:11556504:195294937,257,+
227,chr17,11572348,11572610,chr17:11572348:11572610:195294938,262,-
228,chr17,11572556,11572799,chr17:11572556:11572799:195294939,243,+
229,chr17,11592850,11593079,chr17:11592850:11593079:195294940,229,-
230,chr17,11593030,11593258,chr17:11593030:11593258:195294941,228,+
231,chr17,11593206,11593446,chr17:11593206:11593446:195294942,240,-
232,chr17,11593390,11593619,chr17:11593390:11593619:195294943,229,+
233,chr17,11593564,11593801,chr17:11593564:11593801:195294944,237,-
234,chr17,11631102,11631331,chr17:11631102:11631331:195294945,229,-
235,chr17,11656117,11656368,chr17:11656117:11656368:195294946,251,-
236,chr17,11672408,11672663,chr17:11672408:11672663:195294947,255,-
237,chr17,11672612,11672857,chr17:11672612:11672857:195294948,245,+
238,chr17,11686934,11687163,chr17:11686934:11687163:195294949,229,-
239,chr17,11696765,11697000,chr17:11696765:11697000:195294950,235,-
240,chr17,11696945,11697198,chr17:11696945:11697198:195294951,253,+
241,chr17,11700885,11701138,chr17:11700885:11701138:195294952,253,-
242,chr17,11713530,11713791,chr17:11713530:11713791:195294953,261,-
243,chr17,11726087,11726317,chr17:11726087:11726317:195294954,230,-
244,chr17,11726265,11726518,chr17:11726265:11726518:195294955,253,+
245,chr17,11783364,11783633,chr17:11783364:11783633:195294956,269,-
246,chr17,11797660,11797934,chr17:11797660:11797934:195294957,274,-
247,chr17,11833140,11833382,chr17:11833140:11833382:195294959,242,-
248,chr17,11833328,11833553,chr17:11833328:11833553:195294960,225,+
249,chr17,11840638,11840909,chr17:11840638:11840909:195294961,271,-
250,chr17,11872586,11872850,chr17:11872586:11872850:195294962,264,-
251,chr17,11872796,11873053,chr17:11872796:11873053:195294963,257,+
252,chr17,15952128,15952367,chr17:15952128:15952367:195295019,239,-
253,chr17,15964684,15964909,chr17:15964684:15964909:195295020,225,-
254,chr17,15964854,15965091,chr17:15964854:15965091:195295021,237,+
255,chr17,15965036,15965261,chr17:15965036:15965261:195295022,225,-
256,chr17,15968768,15969026,chr17:15968768:15969026:195295023,258,-
257,chr17,15968972,15969233,chr17:15968972:15969233:195295024,261,+
258,chr17,15971161,15971407,chr17:15971161:15971407:195295025,246,-
259,chr17,15971353,15971579,chr17:15971353:15971579:195295026,226,+
260,chr17,15973448,15973723,chr17:15973448:15973723:195295027,275,-
261,chr17,15973668,15973893,chr17:15973668:15973893:195295028,225,+
262,chr17,16001638,16001912,chr17:16001638:16001912:195295029,274,-
263,chr17,16004535,16004797,chr17:16004535:16004797:195295030,262,-
264,chr17,16004743,16004968,chr17:16004743:16004968:195295031,225,+
265,chr17,16004913,16005184,chr17:16004913:16005184:195295032,271,-
266,chr17,16040588,16040821,chr17:16040588:16040821:195295033,233,-
267,chr17,16055229,16055455,chr17:16055229:16055455:195295034,226,-
268,chr17,16075084,16075320,chr17:16075084:16075320:195295035,236,-
269,chr17,16075264,16075534,chr17:16075264:16075534:195295036,270,+
270,chr17,29482954,29483179,chr17:29482954:29483179:195295110,225,-
271,chr17,29533225,29533472,chr17:29533225:29533472:195295111,247,-
272,chr17,29562903,29563147,chr17:29562903:29563147:195295112,244,-
273,chr17,29588878,29589149,chr17:29588878:29589149:195295113,271,+
274,chr17,29667492,29667731,chr17:29667492:29667731:195295114,239,-
275,chr17,29677146,29677411,chr17:29677146:29677411:195295115,265,-
276,chr17,29679152,29679378,chr17:29679152:29679378:195295116,226,-
277,chr17,29679322,29679565,chr17:29679322:29679565:195295117,243,+
278,chr17,29684242,29684493,chr17:29684242:29684493:195295118,251,-
279,chr17,29685447,29685688,chr17:29685447:29685688:195295119,241,-
280,chr17,74732848,74733085,chr17:74732848:74733085:195295416,237,-
281,chr17,74733032,74733296,chr17:74733032:74733296:195295417,264,+
282,chr18,6950748,6951000,chr18:6950748:6951000:195294858,252,-
283,chr18,6958447,6958672,chr18:6958447:6958672:195294859,225,-
284,chr18,6958617,6958844,chr18:6958617:6958844:195294860,227,+
285,chr18,6977691,6977918,chr18:6977691:6977918:195294861,227,-
286,chr18,6980489,6980714,chr18:6980489:6980714:195294862,225,-
287,chr18,6982465,6982740,chr18:6982465:6982740:195294863,275,-
288,chr18,7002232,7002469,chr18:7002232:7002469:195294864,237,-
289,chr18,7011965,7012218,chr18:7011965:7012218:195294865,253,-
290,chr18,7023132,7023375,chr18:7023132:7023375:195294866,243,-
291,chr18,7023320,7023594,chr18:7023320:7023594:195294867,274,+
292,chr18,7025947,7026189,chr18:7025947:7026189:195294868,242,-
293,chr18,7037550,7037817,chr18:7037550:7037817:195294869,267,-
294,chr18,7038776,7039003,chr18:7038776:7039003:195294870,227,-
295,chr18,42531853,42532090,chr18:42531853:42532090:195295276,237,-
296,chr19,13054503,13054730,chr19:13054503:13054730:195294973,227,-
297,chr19,13054677,13054951,chr19:13054677:13054951:195294974,274,+
298,chr19,13318076,13318330,chr19:13318076:13318330:195294975,254,-
299,chr19,13318282,13318549,chr19:13318282:13318549:195294976,267,+
300,chr19,13318496,13318768,chr19:13318496:13318768:195294977,272,-
301,chr19,13318720,13318945,chr19:13318720:13318945:195294978,225,+
302,chr19,13339484,13339757,chr19:13339484:13339757:195294979,273,-
303,chr19,13363772,13364046,chr19:13363772:13364046:195294980,274,-
304,chr19,13370345,13370592,chr19:13370345:13370592:195294981,247,-
305,chr19,13409325,13409583,chr19:13409325:13409583:195294982,258,-
306,chr19,13409535,13409792,chr19:13409535:13409792:195294983,257,+
307,chr19,13409743,13410004,chr19:13409743:13410004:195294984,261,-
308,chr19,13409953,13410227,chr19:13409953:13410227:195294985,274,+
309,chr19,13410173,13410440,chr19:13410173:13410440:195294986,267,-
310,chr19,13414320,13414591,chr19:13414320:13414591:195294987,271,-
311,chr19,13445111,13445352,chr19:13445111:13445352:195294988,241,-
312,chr19,13445297,13445528,chr19:13445297:13445528:195294989,231,+
313,chr19,13470387,13470646,chr19:13470387:13470646:195294990,259,-
314,chr19,13470591,13470822,chr19:13470591:13470822:195294991,231,+
315,chr19,13482471,13482746,chr19:13482471:13482746:195294992,275,-
316,chr19,17947897,17948169,chr19:17947897:17948169:195295037,272,-
317,chr19,33792213,33792480,chr19:33792213:33792480:195295201,267,-
318,chr19,33792429,33792699,chr19:33792429:33792699:195295202,270,+
319,chr19,33792649,33792924,chr19:33792649:33792924:195295203,275,-
320,chr19,33792873,33793122,chr19:33792873:33793122:195295204,249,+
321,chr19,33793067,33793330,chr19:33793067:33793330:195295205,263,-
322,chr19,33793273,33793514,chr19:33793273:33793514:195295206,241,+
323,chr19,45297430,45297699,chr19:45297430:45297699:195295321,269,-
324,chr19,45303777,45304051,chr19:45303777:45304051:195295322,274,-
325,chr2,25457117,25457348,chr2:25457117:25457348:195295051,231,-
326,chr2,25458547,25458786,chr2:25458547:25458786:195295052,239,-
327,chr2,25459774,25460041,chr2:25459774:25460041:195295053,267,-
328,chr2,25461952,25462195,chr2:25461952:25462195:195295054,243,-
329,chr2,25463140,25463376,chr2:25463140:25463376:195295055,236,-
330,chr2,25463324,25463577,chr2:25463324:25463577:195295056,253,+
331,chr2,25463524,25463777,chr2:25463524:25463777:195295057,253,-
332,chr2,25464396,25464634,chr2:25464396:25464634:195295058,238,-
333,chr2,25466738,25467010,chr2:25466738:25467010:195295059,272,-
334,chr2,25466962,25467236,chr2:25466962:25467236:195295060,274,+
335,chr2,25467186,25467426,chr2:25467186:25467426:195295061,240,-
336,chr2,25467372,25467628,chr2:25467372:25467628:195295062,256,+
337,chr2,25468087,25468344,chr2:25468087:25468344:195295063,257,-
338,chr2,25468856,25469083,chr2:25468856:25469083:195295064,227,-
339,chr2,25469030,25469301,chr2:25469030:25469301:195295065,271,+
340,chr2,25469452,25469691,chr2:25469452:25469691:195295066,239,-
341,chr2,25469640,25469884,chr2:25469640:25469884:195295067,244,+
342,chr2,25469832,25470073,chr2:25469832:25470073:195295068,241,-
343,chr2,25470427,25470654,chr2:25470427:25470654:195295069,227,-
344,chr2,25470877,25471123,chr2:25470877:25471123:195295070,246,-
345,chr2,25471069,25471316,chr2:25471069:25471316:195295071,247,+
346,chr2,25472495,25472720,chr2:25472495:25472720:195295072,225,-
347,chr2,25475030,25475256,chr2:25475030:25475256:195295073,226,-
348,chr2,25497773,25497998,chr2:25497773:25497998:195295074,225,-
349,chr2,25498340,25498565,chr2:25498340:25498565:195295075,225,-
350,chr2,25505226,25505498,chr2:25505226:25505498:195295076,272,-
351,chr2,25505444,25505673,chr2:25505444:25505673:195295077,229,+
352,chr2,25522977,25523239,chr2:25522977:25523239:195295078,262,-
353,chr2,25536751,25536976,chr2:25536751:25536976:195295079,225,-
354,chr2,25964769,25964995,chr2:25964769:25964995:195295080,226,-
355,chr2,25964943,25965168,chr2:25964943:25965168:195295081,225,+
356,chr2,25965113,25965340,chr2:25965113:25965340:195295082,227,-
357,chr2,25965285,25965510,chr2:25965285:25965510:195295083,225,+
358,chr2,25965451,25965679,chr2:25965451:25965679:195295084,228,-
359,chr2,25965621,25965846,chr2:25965621:25965846:195295085,225,+
360,chr2,25965789,25966014,chr2:25965789:25966014:195295086,225,-
361,chr2,25965955,25966180,chr2:25965955:25966180:195295087,225,+
362,chr2,25966125,25966351,chr2:25966125:25966351:195295088,226,-
363,chr2,25966295,25966520,chr2:25966295:25966520:195295089,225,+
364,chr2,25966461,25966687,chr2:25966461:25966687:195295090,226,-
365,chr2,25966631,25966863,chr2:25966631:25966863:195295091,232,+
366,chr2,25966811,25967051,chr2:25966811:25967051:195295092,240,-
367,chr2,25966997,25967272,chr2:25966997:25967272:195295093,275,+
368,chr2,25967217,25967460,chr2:25967217:25967460:195295094,243,-
369,chr2,25972534,25972796,chr2:25972534:25972796:195295095,262,-
370,chr2,25972742,25973014,chr2:25972742:25973014:195295096,272,+
371,chr2,25972960,25973185,chr2:25972960:25973185:195295097,225,-
372,chr2,25973130,25973377,chr2:25973130:25973377:195295098,247,+
373,chr2,25991582,25991835,chr2:25991582:25991835:195295099,253,-
374,chr2,61416012,61416269,chr2:61416012:61416269:195295402,257,-
375,chr2,61433840,61434093,chr2:61433840:61434093:195295403,253,-
376,chr2,61455841,61456089,chr2:61455841:61456089:195295404,248,-
377,chr2,61456035,61456294,chr2:61456035:61456294:195295405,259,+
378,chr2,61462947,61463204,chr2:61462947:61463204:195295406,257,-
379,chr2,61463147,61463372,chr2:61463147:61463372:195295407,225,+
380,chr2,61463317,61463582,chr2:61463317:61463582:195295408,265,-
381,chr2,61472306,61472535,chr2:61472306:61472535:195295409,229,-
382,chr2,61475611,61475885,chr2:61475611:61475885:195295410,274,-
383,chr2,61492387,61492612,chr2:61492387:61492612:195295411,225,-
384,chr2,61492557,61492794,chr2:61492557:61492794:195295412,237,+
385,chr2,61632810,61633085,chr2:61632810:61633085:195295413,275,-
386,chr2,61633026,61633264,chr2:61633026:61633264:195295414,238,+
387,chr2,61633206,61633435,chr2:61633206:61633435:195295415,229,-
388,chr2,100175306,100175569,chr2:100175306:100175569:195295515,263,-
389,chr2,100194758,100194993,chr2:100194758:100194993:195295516,235,-
390,chr2,100209626,100209901,chr2:100209626:100209901:195295517,275,-
391,chr2,100209850,100210125,chr2:100209850:100210125:195295518,275,+
392,chr2,100210074,100210322,chr2:100210074:100210322:195295519,248,-
393,chr2,100210268,100210531,chr2:100210268:100210531:195295520,263,+
394,chr2,100210478,100210738,chr2:100210478:100210738:195295521,260,-
395,chr2,100210684,100210909,chr2:100210684:100210909:195295522,225,+
396,chr2,100217866,100218133,chr2:100217866:100218133:195295523,267,-
397,chr2,100623065,100623335,chr2:100623065:100623335:195295524,270,-
398,chr2,100623283,100623508,chr2:100623283:100623508:195295525,225,+
399,chr2,198266431,198266665,chr2:198266431:198266665:195295883,234,-
400,chr2,198266599,198266839,chr2:198266599:198266839:195295884,240,+
401,chr2,198266787,198267014,chr2:198266787:198267014:195295885,227,-
402,chr2,198267155,198267380,chr2:198267155:198267380:195295886,225,-
403,chr2,198267325,198267560,chr2:198267325:198267560:195295887,235,+
404,chr2,198267505,198267754,chr2:198267505:198267754:195295888,249,-
405,chr2,198267699,198267932,chr2:198267699:198267932:195295889,233,+
406,chr2,209113062,209113294,chr2:209113062:209113294:195295890,232,-
407,chr2,209113240,209113487,chr2:209113240:209113487:195295891,247,+
408,chr20,30956784,30957049,chr20:30956784:30957049:195295166,265,-
409,chr20,31021056,31021303,chr20:31021056:31021303:195295167,247,-
410,chr20,31021250,31021491,chr20:31021250:31021491:195295168,241,+
411,chr20,31021436,31021679,chr20:31021436:31021679:195295169,243,-
412,chr20,31021624,31021879,chr20:31021624:31021879:195295170,255,+
413,chr20,31022112,31022340,chr20:31022112:31022340:195295171,228,-
414,chr20,31022290,31022516,chr20:31022290:31022516:195295172,226,+
415,chr20,31022462,31022692,chr20:31022462:31022692:195295173,230,-
416,chr20,31022606,31022831,chr20:31022606:31022831:195295174,225,+
417,chr20,31022752,31022977,chr20:31022752:31022977:195295175,225,-
418,chr20,31022898,31023123,chr20:31022898:31023123:195295176,225,+
419,chr20,31023038,31023263,chr20:31023038:31023263:195295177,225,-
420,chr20,31023180,31023405,chr20:31023180:31023405:195295178,225,+
421,chr20,31023322,31023547,chr20:31023322:31023547:195295179,225,-
422,chr20,31023466,31023691,chr20:31023466:31023691:195295180,225,+
423,chr20,31023610,31023836,chr20:31023610:31023836:195295181,226,-
424,chr20,31023752,31023977,chr20:31023752:31023977:195295182,225,+
425,chr20,31023896,31024124,chr20:31023896:31024124:195295183,228,-
426,chr20,31024036,31024262,chr20:31024036:31024262:195295184,226,+
427,chr20,31024198,31024423,chr20:31024198:31024423:195295185,225,-
428,chr20,31024344,31024572,chr20:31024344:31024572:195295186,228,+
429,chr20,31024518,31024755,chr20:31024518:31024755:195295187,237,-
430,chr20,31024700,31024951,chr20:31024700:31024951:195295188,251,+
431,chr20,31024896,31025158,chr20:31024896:31025158:195295189,262,-
432,chr20,31025102,31025347,chr20:31025102:31025347:195295190,245,+
433,chr20,57484372,57484620,chr20:57484372:57484620:195295400,248,-
434,chr20,57484568,57484802,chr20:57484568:57484802:195295401,234,+
435,chr21,36164313,36164578,chr21:36164313:36164578:195295207,265,-
436,chr21,36164525,36164773,chr21:36164525:36164773:195295208,248,+
437,chr21,36164719,36164951,chr21:36164719:36164951:195295209,232,-
438,chr21,36171567,36171804,chr21:36171567:36171804:195295210,237,-
439,chr21,36193934,36194165,chr21:36193934:36194165:195295211,231,-
440,chr21,36206674,36206906,chr21:36206674:36206906:195295212,232,-
441,chr21,36206850,36207080,chr21:36206850:36207080:195295213,230,+
442,chr21,36231736,36231993,chr21:36231736:36231993:195295214,257,-
443,chr21,36252823,36253050,chr21:36252823:36253050:195295215,227,-
444,chr21,36259109,36259353,chr21:36259109:36259353:195295216,244,-
445,chr21,36259305,36259531,chr21:36259305:36259531:195295217,226,+
446,chr21,36265165,36265391,chr21:36265165:36265391:195295218,226,-
447,chr21,36421106,36421371,chr21:36421106:36421371:195295219,265,-
448,chr21,44514734,44514969,chr21:44514734:44514969:195295278,235,-
449,chr21,44524364,44524591,chr21:44524364:44524591:195295279,227,-
450,chr3,38181852,38182100,chr3:38181852:38182100:195295230,248,-
451,chr3,38182048,38182321,chr3:38182048:38182321:195295231,273,+
452,chr3,38182266,38182515,chr3:38182266:38182515:195295232,249,-
453,chr3,38182592,38182867,chr3:38182592:38182867:195295233,275,-
454,chr3,47059097,47059366,chr3:47059097:47059366:195295323,269,-
455,chr3,47084018,47084245,chr3:47084018:47084245:195295324,227,-
456,chr3,47087944,47088187,chr3:47087944:47088187:195295325,243,-
457,chr3,47098278,47098513,chr3:47098278:47098513:195295326,235,-
458,chr3,47098458,47098690,chr3:47098458:47098690:195295327,232,+
459,chr3,47098636,47098867,chr3:47098636:47098867:195295328,231,-
460,chr3,47098812,47099081,chr3:47098812:47099081:195295329,269,+
461,chr3,47125179,47125452,chr3:47125179:47125452:195295330,273,-
462,chr3,47125397,47125667,chr3:47125397:47125667:195295331,270,+
463,chr3,47125613,47125842,chr3:47125613:47125842:195295332,229,-
464,chr3,47144805,47145053,chr3:47144805:47145053:195295333,248,-
465,chr3,47147456,47147681,chr3:47147456:47147681:195295334,225,-
466,chr3,47158082,47158345,chr3:47158082:47158345:195295335,263,-
467,chr3,47161541,47161768,chr3:47161541:47161768:195295336,227,-
468,chr3,47161713,47161938,chr3:47161713:47161938:195295337,225,+
469,chr3,47161881,47162107,chr3:47161881:47162107:195295338,226,-
470,chr3,47162051,47162276,chr3:47162051:47162276:195295339,225,+
471,chr3,47162193,47162419,chr3:47162193:47162419:195295340,226,-
472,chr3,47162333,47162558,chr3:47162333:47162558:195295341,225,+
473,chr3,47162501,47162726,chr3:47162501:47162726:195295342,225,-
474,chr3,47162665,47162891,chr3:47162665:47162891:195295343,226,+
475,chr3,47162807,47163033,chr3:47162807:47163033:195295344,226,-
476,chr3,47162973,47163199,chr3:47162973:47163199:195295345,226,+
477,chr3,47163111,47163336,chr3:47163111:47163336:195295346,225,-
478,chr3,47163251,47163476,chr3:47163251:47163476:195295347,225,+
479,chr3,47163391,47163617,chr3:47163391:47163617:195295348,226,-
480,chr3,47163527,47163752,chr3:47163527:47163752:195295349,225,+
481,chr3,47163693,47163919,chr3:47163693:47163919:195295350,226,-
482,chr3,47163835,47164060,chr3:47163835:47164060:195295351,225,+
483,chr3,47163975,47164201,chr3:47163975:47164201:195295352,226,-
484,chr3,47164139,47164366,chr3:47164139:47164366:195295353,227,+
485,chr3,47164283,47164508,chr3:47164283:47164508:195295354,225,-
486,chr3,47164421,47164647,chr3:47164421:47164647:195295355,226,+
487,chr3,47164583,47164809,chr3:47164583:47164809:195295356,226,-
488,chr3,47164721,47164947,chr3:47164721:47164947:195295357,226,+
489,chr3,47164889,47165117,chr3:47164889:47165117:195295358,228,-
490,chr3,47165055,47165280,chr3:47165055:47165280:195295359,225,+
491,chr3,47165223,47165454,chr3:47165223:47165454:195295360,231,-
492,chr3,47165399,47165634,chr3:47165399:47165634:195295361,235,+
493,chr3,47165579,47165830,chr3:47165579:47165830:195295362,251,-
494,chr3,47165775,47166042,chr3:47165775:47166042:195295363,267,+
495,chr3,47165987,47166258,chr3:47165987:47166258:195295364,271,-
496,chr3,105438858,105439104,chr3:105438858:105439104:195295544,246,-
497,chr3,105439050,105439305,chr3:105439050:105439305:195295545,255,+
498,chr3,105452822,105453071,chr3:105452822:105453071:195295546,249,-
499,chr3,128199833,128200058,chr3:128199833:128200058:195295669,225,-
500,chr3,128200005,128200279,chr3:128200005:128200279:195295670,274,+
501,chr3,128200615,128200887,chr3:128200615:128200887:195295671,272,-
502,chr3,128202670,128202898,chr3:128202670:128202898:195295672,228,-
503,chr3,128204539,128204807,chr3:128204539:128204807:195295673,268,-
504,chr3,128204753,128205003,chr3:128204753:128205003:195295674,250,+
505,chr3,128204955,128205205,chr3:128204955:128205205:195295675,250,-
506,chr3,128205151,128205382,chr3:128205151:128205382:195295676,231,+
507,chr3,128205613,128205858,chr3:128205613:128205858:195295677,245,-
508,chr3,128205805,128206075,chr3:128205805:128206075:195295678,270,+
509,chr4,24531169,24531406,chr4:24531169:24531406:195295038,237,-
510,chr4,24531351,24531606,chr4:24531351:24531606:195295039,255,+
511,chr4,24534382,24534610,chr4:24534382:24534610:195295040,228,-
512,chr4,24534556,24534803,chr4:24534556:24534803:195295041,247,+
513,chr4,24572242,24572476,chr4:24572242:24572476:195295042,234,-
514,chr4,24572422,24572675,chr4:24572422:24572675:195295043,253,+
515,chr4,24577781,24578046,chr4:24577781:24578046:195295044,265,-
516,chr4,24577991,24578250,chr4:24577991:24578250:195295045,259,+
517,chr4,24578195,24578468,chr4:24578195:24578468:195295046,273,-
518,chr4,55140977,55141252,chr4:55140977:55141252:195295386,275,-
519,chr4,55144030,55144255,chr4:55144030:55144255:195295387,225,-
520,chr4,55151977,55152212,chr4:55151977:55152212:195295388,235,-
521,chr4,55561647,55561920,chr4:55561647:55561920:195295389,273,-
522,chr4,55561867,55562102,chr4:55561867:55562102:195295390,235,+
523,chr4,55575559,55575790,chr4:55575559:55575790:195295391,231,-
524,chr4,55589715,55589940,chr4:55589715:55589940:195295392,225,-
525,chr4,55591994,55592269,chr4:55591994:55592269:195295393,275,-
526,chr4,55593353,55593628,chr4:55593353:55593628:195295394,275,-
527,chr4,55593573,55593824,chr4:55593573:55593824:195295395,251,+
528,chr4,55594146,55594419,chr4:55594146:55594419:195295396,273,-
529,chr4,55598006,55598263,chr4:55598006:55598263:195295397,257,-
530,chr4,55599203,55599472,chr4:55599203:55599472:195295398,269,-
531,chr4,55602629,55602866,chr4:55602629:55602866:195295399,237,-
532,chr4,106154925,106155150,chr4:106154925:106155150:195295547,225,-
533,chr4,106155093,106155319,chr4:106155093:106155319:195295548,226,+
534,chr4,106155237,106155462,chr4:106155237:106155462:195295549,225,-
535,chr4,106155377,106155602,chr4:106155377:106155602:195295550,225,+
536,chr4,106155515,106155740,chr4:106155515:106155740:195295551,225,-
537,chr4,106155681,106155907,chr4:106155681:106155907:195295552,226,+
538,chr4,106155847,106156072,chr4:106155847:106156072:195295553,225,-
539,chr4,106156011,106156236,chr4:106156011:106156236:195295554,225,+
540,chr4,106156177,106156402,chr4:106156177:106156402:195295555,225,-
541,chr4,106156341,106156566,chr4:106156341:106156566:195295556,225,+
542,chr4,106156505,106156730,chr4:106156505:106156730:195295557,225,-
543,chr4,106156675,106156901,chr4:106156675:106156901:195295558,226,+
544,chr4,106156843,106157069,chr4:106156843:106157069:195295559,226,-
545,chr4,106156985,106157210,chr4:106156985:106157210:195295560,225,+
546,chr4,106157153,106157378,chr4:106157153:106157378:195295561,225,-
547,chr4,106157293,106157518,chr4:106157293:106157518:195295562,225,+
548,chr4,106157431,106157656,chr4:106157431:106157656:195295563,225,-
549,chr4,106157599,106157824,chr4:106157599:106157824:195295564,225,+
550,chr4,106157771,106157997,chr4:106157771:106157997:195295565,226,-
551,chr4,106157943,106158168,chr4:106157943:106158168:195295566,225,+
552,chr4,106158113,106158342,chr4:106158113:106158342:195295567,229,-
553,chr4,106158287,106158521,chr4:106158287:106158521:195295568,234,+
554,chr4,106158467,106158692,chr4:106158467:106158692:195295569,225,-
555,chr4,106162403,106162670,chr4:106162403:106162670:195295570,267,-
556,chr4,106163954,106164179,chr4:106163954:106164179:195295571,225,-
557,chr4,106164696,106164966,chr4:106164696:106164966:195295572,270,-
558,chr4,106164912,106165173,chr4:106164912:106165173:195295573,261,+
559,chr4,106180743,106181005,chr4:106180743:106181005:195295574,262,-
560,chr4,106182809,106183050,chr4:106182809:106183050:195295575,241,-
561,chr4,106190726,106190958,chr4:106190726:106190958:195295576,232,-
562,chr4,106193690,106193964,chr4:106193690:106193964:195295577,274,-
563,chr4,106193910,106194183,chr4:106193910:106194183:195295578,273,+
564,chr4,106196176,106196408,chr4:106196176:106196408:195295579,232,-
565,chr4,106196354,106196585,chr4:106196354:106196585:195295580,231,+
566,chr4,106196530,106196771,chr4:106196530:106196771:195295581,241,-
567,chr4,106196714,106196951,chr4:106196714:106196951:195295582,237,+
568,chr4,106196896,106197143,chr4:106196896:106197143:195295583,247,-
569,chr4,106197088,106197327,chr4:106197088:106197327:195295584,239,+
570,chr4,106197272,106197497,chr4:106197272:106197497:195295585,225,-
571,chr4,106197442,106197717,chr4:106197442:106197717:195295586,275,+
572,chr4,153245305,153245552,chr4:153245305:153245552:195295789,247,-
573,chr4,153245497,153245758,chr4:153245497:153245758:195295790,261,+
574,chr4,153247127,153247371,chr4:153247127:153247371:195295791,244,-
575,chr4,153247317,153247584,chr4:153247317:153247584:195295792,267,+
576,chr4,153249331,153249562,chr4:153249331:153249562:195295793,231,-
577,chr4,153249507,153249764,chr4:153249507:153249764:195295794,257,+
578,chr4,187517663,187517928,chr4:187517663:187517928:195295813,265,-
579,chr4,187517873,187518126,chr4:187517873:187518126:195295814,253,+
580,chr4,187518071,187518345,chr4:187518071:187518345:195295815,274,-
581,chr4,187518289,187518516,chr4:187518289:187518516:195295816,227,+
582,chr4,187524024,187524255,chr4:187524024:187524255:195295817,231,-
583,chr4,187524198,187524445,chr4:187524198:187524445:195295818,247,+
584,chr4,187524390,187524643,chr4:187524390:187524643:195295819,253,-
585,chr4,187524588,187524860,chr4:187524588:187524860:195295820,272,+
586,chr4,187524806,187525076,chr4:187524806:187525076:195295821,270,-
587,chr4,187525022,187525257,chr4:187525022:187525257:195295822,235,+
588,chr4,187525500,187525727,chr4:187525500:187525727:195295823,227,-
589,chr4,187525672,187525911,chr4:187525672:187525911:195295824,239,+
590,chr4,187530306,187530537,chr4:187530306:187530537:195295825,231,-
591,chr4,187532509,187532738,chr4:187532509:187532738:195295826,229,-
592,chr4,187532683,187532916,chr4:187532683:187532916:195295827,233,+
593,chr4,187532861,187533132,chr4:187532861:187533132:195295828,271,-
594,chr4,187535312,187535569,chr4:187535312:187535569:195295829,257,-
595,chr4,187538747,187538973,chr4:187538747:187538973:195295830,226,-
596,chr4,187538887,187539112,chr4:187538887:187539112:195295831,225,+
597,chr4,187539047,187539273,chr4:187539047:187539273:195295832,226,-
598,chr4,187539189,187539414,chr4:187539189:187539414:195295833,225,+
599,chr4,187539329,187539554,chr4:187539329:187539554:195295834,225,-
600,chr4,187539473,187539699,chr4:187539473:187539699:195295835,226,+
601,chr4,187539609,187539834,chr4:187539609:187539834:195295836,225,-
602,chr4,187539775,187540000,chr4:187539775:187540000:195295837,225,+
603,chr4,187539915,187540140,chr4:187539915:187540140:195295838,225,-
604,chr4,187540083,187540309,chr4:187540083:187540309:195295839,226,+
605,chr4,187540223,187540448,chr4:187540223:187540448:195295840,225,-
606,chr4,187540361,187540587,chr4:187540361:187540587:195295841,226,+
607,chr4,187540527,187540752,chr4:187540527:187540752:195295842,225,-
608,chr4,187540673,187540898,chr4:187540673:187540898:195295843,225,+
609,chr4,187540817,187541042,chr4:187540817:187541042:195295844,225,-
610,chr4,187540959,187541184,chr4:187540959:187541184:195295845,225,+
611,chr4,187541105,187541331,chr4:187541105:187541331:195295846,226,-
612,chr4,187541251,187541476,chr4:187541251:187541476:195295847,225,+
613,chr4,187541399,187541625,chr4:187541399:187541625:195295848,226,-
614,chr4,187541543,187541769,chr4:187541543:187541769:195295849,226,+
615,chr4,187541685,187541910,chr4:187541685:187541910:195295850,225,-
616,chr4,187541821,187542046,chr4:187541821:187542046:195295851,225,+
617,chr4,187541991,187542221,chr4:187541991:187542221:195295852,230,-
618,chr4,187542165,187542428,chr4:187542165:187542428:195295853,263,+
619,chr4,187542373,187542600,chr4:187542373:187542600:195295854,227,-
620,chr4,187542545,187542815,chr4:187542545:187542815:195295855,270,+
621,chr4,187542761,187542986,chr4:187542761:187542986:195295856,225,-
622,chr4,187549277,187549528,chr4:187549277:187549528:195295857,251,-
623,chr4,187549473,187549710,chr4:187549473:187549710:195295858,237,+
624,chr4,187557696,187557960,chr4:187557696:187557960:195295859,264,-
625,chr4,187557908,187558141,chr4:187557908:187558141:195295860,233,+
626,chr4,187627590,187627815,chr4:187627590:187627815:195295861,225,-
627,chr4,187627736,187627962,chr4:187627736:187627962:195295862,226,+
628,chr4,187627882,187628107,chr4:187627882:187628107:195295863,225,-
629,chr4,187628022,187628248,chr4:187628022:187628248:195295864,226,+
630,chr4,187628184,187628409,chr4:187628184:187628409:195295865,225,-
631,chr4,187628322,187628547,chr4:187628322:187628547:195295866,225,+
632,chr4,187628484,187628710,chr4:187628484:187628710:195295867,226,-
633,chr4,187628648,187628873,chr4:187628648:187628873:195295868,225,+
634,chr4,187628790,187629016,chr4:187628790:187629016:195295869,226,-
635,chr4,187628930,187629156,chr4:187628930:187629156:195295870,226,+
636,chr4,187629098,187629323,chr4:187629098:187629323:195295871,225,-
637,chr4,187629262,187629488,chr4:187629262:187629488:195295872,226,+
638,chr4,187629404,187629629,chr4:187629404:187629629:195295873,225,-
639,chr4,187629546,187629771,chr4:187629546:187629771:195295874,225,+
640,chr4,187629708,187629934,chr4:187629708:187629934:195295875,226,-
641,chr4,187629850,187630075,chr4:187629850:187630075:195295876,225,+
642,chr4,187629990,187630216,chr4:187629990:187630216:195295877,226,-
643,chr4,187630160,187630388,chr4:187630160:187630388:195295878,228,+
644,chr4,187630332,187630557,chr4:187630332:187630557:195295879,225,-
645,chr4,187630502,187630767,chr4:187630502:187630767:195295880,265,+
646,chr4,187630712,187630971,chr4:187630712:187630971:195295881,259,-
647,chr4,187630916,187631145,chr4:187630916:187631145:195295882,229,+
648,chr5,170817014,170817273,chr5:170817014:170817273:195295795,259,-
649,chr5,170818677,170818948,chr5:170818677:170818948:195295796,271,-
650,chr5,170819671,170819896,chr5:170819671:170819896:195295797,225,-
651,chr5,170832273,170832525,chr5:170832273:170832525:195295798,252,-
652,chr5,170837492,170837733,chr5:170837492:170837733:195295799,241,-
653,chr5,180036872,180037120,chr5:180036872:180037120:195295800,248,-
654,chr5,180039475,180039743,chr5:180039475:180039743:195295801,268,-
655,chr5,180043334,180043561,chr5:180043334:180043561:195295802,227,-
656,chr5,180046154,180046394,chr5:180046154:180046394:195295803,240,-
657,chr5,180046344,180046577,chr5:180046344:180046577:195295804,233,+
658,chr5,180047578,180047831,chr5:180047578:180047831:195295805,253,-
659,chr5,180048503,180048752,chr5:180048503:180048752:195295806,249,-
660,chr5,180048701,180048958,chr5:180048701:180048958:195295807,257,+
661,chr5,180055849,180056121,chr5:180055849:180056121:195295808,272,-
662,chr5,180056071,180056307,chr5:180056071:180056307:195295809,236,+
663,chr5,180056257,180056495,chr5:180056257:180056495:195295810,238,-
664,chr5,180057524,180057786,chr5:180057524:180057786:195295811,262,-
665,chr5,180057736,180057962,chr5:180057736:180057962:195295812,226,+
666,chr6,41903653,41903878,chr6:41903653:41903878:195295273,225,-
667,chr6,41908069,41908295,chr6:41908069:41908295:195295274,226,-
668,chr6,41908245,41908472,chr6:41908245:41908472:195295275,227,+
669,chr6,75799797,75800062,chr6:75799797:75800062:195295418,265,-
670,chr6,75800007,75800236,chr6:75800007:75800236:195295419,229,+
671,chr6,75818701,75818958,chr6:75818701:75818958:195295420,257,-
672,chr6,75822819,75823044,chr6:75822819:75823044:195295421,225,-
673,chr6,75822973,75823201,chr6:75822973:75823201:195295422,228,+
674,chr6,75825471,75825740,chr6:75825471:75825740:195295423,269,-
675,chr6,75830985,75831256,chr6:75830985:75831256:195295424,271,-
676,chr6,75833924,75834181,chr6:75833924:75834181:195295425,257,-
677,chr6,75855011,75855246,chr6:75855011:75855246:195295426,235,-
678,chr6,75862018,75862257,chr6:75862018:75862257:195295427,239,-
679,chr6,75865934,75866191,chr6:75865934:75866191:195295428,257,-
680,chr6,75866138,75866369,chr6:75866138:75866369:195295429,231,+
681,chr6,75875192,75875428,chr6:75875192:75875428:195295430,236,-
682,chr6,75875374,75875643,chr6:75875374:75875643:195295431,269,+
683,chr6,75892727,75892980,chr6:75892727:75892980:195295432,253,-
684,chr6,75892925,75893165,chr6:75892925:75893165:195295433,240,+
685,chr6,75893107,75893362,chr6:75893107:75893362:195295434,255,-
686,chr6,75893307,75893536,chr6:75893307:75893536:195295435,229,+
687,chr6,131913485,131913718,chr6:131913485:131913718:195295686,233,-
688,chr6,131914115,131914360,chr6:131914115:131914360:195295687,245,-
689,chr6,131937016,131937263,chr6:131937016:131937263:195295688,247,-
690,chr6,131944444,131944693,chr6:131944444:131944693:195295689,249,-
691,chr6,138550888,138551135,chr6:138550888:138551135:195295740,247,-
692,chr6,138583807,138584049,chr6:138583807:138584049:195295741,242,-
693,chr6,138583999,138584237,chr6:138583999:138584237:195295742,238,+
694,chr6,138584185,138584452,chr6:138584185:138584452:195295743,267,-
695,chr6,138584397,138584651,chr6:138584397:138584651:195295744,254,+
696,chr6,138584595,138584826,chr6:138584595:138584826:195295745,231,-
697,chr6,138599559,138599799,chr6:138599559:138599799:195295746,240,-
698,chr6,138608180,138608442,chr6:138608180:138608442:195295747,262,-
699,chr6,138612841,138613082,chr6:138612841:138613082:195295748,241,-
700,chr6,138613031,138613297,chr6:138613031:138613297:195295749,266,+
701,chr6,138632513,138632768,chr6:138632513:138632768:195295750,255,-
702,chr6,138638353,138638592,chr6:138638353:138638592:195295751,239,-
703,chr7,50358628,50358889,chr7:50358628:50358889:195295371,261,-
704,chr7,50367203,50367476,chr7:50367203:50367476:195295372,273,-
705,chr7,50444202,50444439,chr7:50444202:50444439:195295373,237,-
706,chr7,50444384,50444619,chr7:50444384:50444619:195295374,235,+
707,chr7,50450211,50450474,chr7:50450211:50450474:195295375,263,-
708,chr7,50455012,50455274,chr7:50455012:50455274:195295376,262,-
709,chr7,50459397,50459640,chr7:50459397:50459640:195295377,243,-
710,chr7,50467583,50467821,chr7:50467583:50467821:195295378,238,-
711,chr7,50467773,50468003,chr7:50467773:50468003:195295379,230,+
712,chr7,50467949,50468212,chr7:50467949:50468212:195295380,263,-
713,chr7,50468159,50468434,chr7:50468159:50468434:195295381,275,+
714,chr7,98495311,98495555,chr7:98495311:98495555:195295490,244,-
715,chr7,98508663,98508907,chr7:98508663:98508907:195295491,244,-
716,chr7,98508851,98509124,chr7:98508851:98509124:195295492,273,+
717,chr7,98515015,98515268,chr7:98515015:98515268:195295493,253,-
718,chr7,98515217,98515444,chr7:98515217:98515444:195295494,227,+
719,chr7,98540543,98540802,chr7:98540543:98540802:195295495,259,-
720,chr7,98543285,98543558,chr7:98543285:98543558:195295496,273,-
721,chr7,98547656,98547927,chr7:98547656:98547927:195295497,271,-
722,chr7,98547872,98548111,chr7:98547872:98548111:195295498,239,+
723,chr7,98548452,98548681,chr7:98548452:98548681:195295499,229,-
724,chr7,98552680,98552950,chr7:98552680:98552950:195295500,270,-
725,chr7,98552902,98553135,chr7:98552902:98553135:195295501,233,+
726,chr7,98555573,98555804,chr7:98555573:98555804:195295502,231,-
727,chr7,98563290,98563563,chr7:98563290:98563563:195295503,273,-
728,chr7,98565077,98565308,chr7:98565077:98565308:195295504,231,-
729,chr7,98565255,98565484,chr7:98565255:98565484:195295505,229,+
730,chr7,98574531,98574790,chr7:98574531:98574790:195295506,259,-
731,chr7,98586357,98586602,chr7:98586357:98586602:195295507,245,-
732,chr7,98586549,98586824,chr7:98586549:98586824:195295508,275,+
733,chr7,98601772,98602024,chr7:98601772:98602024:195295509,252,-
734,chr7,98601970,98602205,chr7:98601970:98602205:195295510,235,+
735,chr7,98605967,98606199,chr7:98605967:98606199:195295511,232,-
736,chr7,98606153,98606394,chr7:98606153:98606394:195295512,241,+
737,chr7,98608933,98609208,chr7:98608933:98609208:195295513,275,-
738,chr7,98609153,98609408,chr7:98609153:98609408:195295514,255,+
739,chr7,103123289,103123560,chr7:103123289:103123560:195295526,271,-
740,chr7,103124067,103124308,chr7:103124067:103124308:195295527,241,-
741,chr7,103124249,103124474,chr7:103124249:103124474:195295528,225,+
742,chr7,103131084,103131359,chr7:103131084:103131359:195295529,275,-
743,chr7,103138481,103138726,chr7:103138481:103138726:195295530,245,-
744,chr7,103180611,103180869,chr7:103180611:103180869:195295531,258,-
745,chr7,103180815,103181050,chr7:103180815:103181050:195295532,235,+
746,chr7,103205694,103205921,chr7:103205694:103205921:195295533,227,-
747,chr7,103205866,103206129,chr7:103205866:103206129:195295534,263,+
748,chr7,103206636,103206871,chr7:103206636:103206871:195295535,235,-
749,chr7,103206816,103207047,chr7:103206816:103207047:195295536,231,+
750,chr7,103212600,103212847,chr7:103212600:103212847:195295537,247,-
751,chr7,103214506,103214733,chr7:103214506:103214733:195295538,227,-
752,chr7,103214678,103214903,chr7:103214678:103214903:195295539,225,+
753,chr7,103215964,103216195,chr7:103215964:103216195:195295540,231,-
754,chr7,103389842,103390113,chr7:103389842:103390113:195295541,271,-
755,chr7,103629545,103629783,chr7:103629545:103629783:195295542,238,-
756,chr7,103629735,103630000,chr7:103629735:103630000:195295543,265,+
757,chr7,135260963,135261205,chr7:135260963:135261205:195295724,242,-
758,chr7,135261636,135261869,chr7:135261636:135261869:195295725,233,-
759,chr7,135261816,135262069,chr7:135261816:135262069:195295726,253,+
760,chr7,135285525,135285754,chr7:135285525:135285754:195295727,229,-
761,chr7,135300631,135300880,chr7:135300631:135300880:195295728,249,-
762,chr7,135322564,135322814,chr7:135322564:135322814:195295729,250,-
763,chr7,135329610,135329859,chr7:135329610:135329859:195295730,249,-
764,chr7,135333121,135333358,chr7:135333121:135333358:195295731,237,-
765,chr7,138252179,138252440,chr7:138252179:138252440:195295732,261,-
766,chr7,138263826,138264080,chr7:138263826:138264080:195295733,254,-
767,chr7,138264026,138264301,chr7:138264026:138264301:195295734,275,+
768,chr7,138264246,138264511,chr7:138264246:138264511:195295735,265,-
769,chr7,138265276,138265525,chr7:138265276:138265525:195295736,249,-
770,chr7,138266343,138266568,chr7:138266343:138266568:195295737,225,-
771,chr7,138269392,138269667,chr7:138269392:138269667:195295738,275,-
772,chr7,138269612,138269871,chr7:138269612:138269871:195295739,259,+
773,chr7,140453044,140453272,chr7:140453044:140453272:195295766,228,-
774,chr7,148504689,148504950,chr7:148504689:148504950:195295767,261,-
775,chr7,148506130,148506364,chr7:148506130:148506364:195295768,234,-
776,chr7,148506308,148506583,chr7:148506308:148506583:195295769,275,+
777,chr7,148507392,148507623,chr7:148507392:148507623:195295770,231,-
778,chr7,148508686,148508923,chr7:148508686:148508923:195295771,237,-
779,chr7,148511020,148511268,chr7:148511020:148511268:195295772,248,-
780,chr7,148511216,148511445,chr7:148511216:148511445:195295773,229,+
781,chr7,148511975,148512222,chr7:148511975:148512222:195295774,247,-
782,chr7,148512567,148512806,chr7:148512567:148512806:195295775,239,-
783,chr7,148513745,148514004,chr7:148513745:148514004:195295776,259,-
784,chr7,148514279,148514524,chr7:148514279:148514524:195295777,245,-
785,chr7,148514928,148515194,chr7:148514928:148515194:195295778,266,-
786,chr7,148515140,148515385,chr7:148515140:148515385:195295779,245,+
787,chr7,148516657,148516928,chr7:148516657:148516928:195295780,271,-
788,chr7,148523513,148523739,chr7:148523513:148523739:195295781,226,-
789,chr7,148523681,148523906,chr7:148523681:148523906:195295782,225,+
790,chr7,148524225,148524454,chr7:148524225:148524454:195295783,229,-
791,chr7,148525795,148526068,chr7:148525795:148526068:195295784,273,-
792,chr7,148526789,148527050,chr7:148526789:148527050:195295785,261,-
793,chr7,148529631,148529902,chr7:148529631:148529902:195295786,271,-
794,chr7,148543515,148543740,chr7:148543515:148543740:195295787,225,-
795,chr7,148544199,148544459,chr7:148544199:148544459:195295788,260,-
796,chr8,117859706,117859943,chr8:117859706:117859943:195295597,237,-
797,chr8,117859888,117860135,chr8:117859888:117860135:195295598,247,+
798,chr8,117861156,117861415,chr8:117861156:117861415:195295599,259,-
799,chr8,117862814,117863088,chr8:117862814:117863088:195295600,274,-
800,chr8,117864154,117864387,chr8:117864154:117864387:195295601,233,-
801,chr8,117864757,117865030,chr8:117864757:117865030:195295602,273,-
802,chr8,117866371,117866605,chr8:117866371:117866605:195295603,234,-
803,chr8,117866549,117866824,chr8:117866549:117866824:195295604,275,+
804,chr8,117868372,117868603,chr8:117868372:117868603:195295605,231,-
805,chr8,117868852,117869085,chr8:117868852:117869085:195295606,233,-
806,chr8,117869467,117869700,chr8:117869467:117869700:195295607,233,-
807,chr8,117869645,117869918,chr8:117869645:117869918:195295608,273,+
808,chr8,117870494,117870719,chr8:117870494:117870719:195295609,225,-
809,chr8,117870662,117870928,chr8:117870662:117870928:195295610,266,+
810,chr8,117874033,117874262,chr8:117874033:117874262:195295611,229,-
811,chr8,117875336,117875605,chr8:117875336:117875605:195295612,269,-
812,chr8,117878790,117879015,chr8:117878790:117879015:195295613,225,-
813,chr8,128750467,128750742,chr8:128750467:128750742:195295679,275,-
814,chr8,128750689,128750915,chr8:128750689:128750915:195295680,226,+
815,chr8,128750861,128751125,chr8:128750861:128751125:195295681,264,-
816,chr8,128751073,128751326,chr8:128751073:128751326:195295682,253,+
817,chr8,128752607,128752871,chr8:128752607:128752871:195295683,264,-
818,chr8,128752819,128753073,chr8:128752819:128753073:195295684,254,+
819,chr8,128753017,128753292,chr8:128753017:128753292:195295685,275,-
820,chr9,5069872,5070132,chr9:5069872:5070132:195294856,260,-
821,chr9,5073657,5073886,chr9:5073657:5073886:195294857,229,-
822,chr9,133738119,133738394,chr9:133738119:133738394:195295703,275,-
823,chr9,133738345,133738596,chr9:133738345:133738596:195295704,251,+
824,chr9,133747475,133747725,chr9:133747475:133747725:195295705,250,-
825,chr9,133748218,133748463,chr9:133748218:133748463:195295706,245,-
826,chr9,134003678,134003931,chr9:134003678:134003931:195295707,253,-
827,chr9,134019626,134019859,chr9:134019626:134019859:195295708,233,-
828,chr9,134019804,134020048,chr9:134019804:134020048:195295709,244,+
829,chr9,134019994,134020239,chr9:134019994:134020239:195295710,245,-
830,chr9,134072478,134072706,chr9:134072478:134072706:195295711,228,-
831,chr9,134072646,134072873,chr9:134072646:134072873:195295712,227,+
832,chr9,134072818,134073044,chr9:134072818:134073044:195295713,226,-
833,chr9,134072988,134073214,chr9:134072988:134073214:195295714,226,+
834,chr9,134073158,134073383,chr9:134073158:134073383:195295715,225,-
835,chr9,134073328,134073553,chr9:134073328:134073553:195295716,225,+
836,chr9,134073494,134073721,chr9:134073494:134073721:195295717,227,-
837,chr9,134073662,134073888,chr9:134073662:134073888:195295718,226,+
838,chr9,134073832,134074058,chr9:134073832:134074058:195295719,226,-
839,chr9,134074002,134074241,chr9:134074002:134074241:195295720,239,+
840,chr9,134074186,134074443,chr9:134074186:134074443:195295721,257,-
841,chr9,134074388,134074637,chr9:134074388:134074637:195295722,249,+
842,chr9,134098134,134098409,chr9:134098134:134098409:195295723,275,-
843,chr9,139390493,139390735,chr9:139390493:139390735:195295752,242,-
844,chr9,139390687,139390949,chr9:139390687:139390949:195295753,262,+
845,chr9,139390897,139391130,chr9:139390897:139391130:195295754,233,-
846,chr9,139391077,139391310,chr9:139391077:139391310:195295755,233,+
847,chr9,139391255,139391493,chr9:139391255:139391493:195295756,238,-
848,chr9,139391443,139391689,chr9:139391443:139391689:195295757,246,+
849,chr9,139391637,139391895,chr9:139391637:139391895:195295758,258,-
850,chr9,139391841,139392102,chr9:139391841:139392102:195295759,261,+
851,chr9,139396687,139396919,chr9:139396687:139396919:195295760,232,-
852,chr9,139396869,139397136,chr9:139396869:139397136:195295761,267,+
853,chr9,139397601,139397867,chr9:139397601:139397867:195295762,266,-
854,chr9,139399094,139399329,chr9:139399094:139399329:195295763,235,-
855,chr9,139399280,139399512,chr9:139399280:139399512:195295764,232,+
856,chr9,139399460,139399686,chr9:139399460:139399686:195295765,226,-
857,chrX,15808584,15808859,chrX:15808584:15808859:195294994,275,-
858,chrX,15809022,15809281,chrX:15809022:15809281:195294995,259,-
859,chrX,15817956,15818186,chrX:15817956:15818186:195295002,230,-
860,chrX,15821770,15821999,chrX:15821770:15821999:195295003,229,-
861,chrX,15822201,15822474,chrX:15822201:15822474:195295004,273,-
862,chrX,15826325,15826594,chrX:15826325:15826594:195295005,269,-
863,chrX,15827290,15827559,chrX:15827290:15827559:195295006,269,-
864,chrX,15833767,15834015,chrX:15833767:15834015:195295007,248,-
865,chrX,15833961,15834236,chrX:15833961:15834236:195295008,275,+
866,chrX,15836609,15836848,chrX:15836609:15836848:195295011,239,-
867,chrX,15838295,15838534,chrX:15838295:15838534:195295012,239,-
868,chrX,15840825,15841096,chrX:15840825:15841096:195295013,271,-
869,chrX,15841043,15841318,chrX:15841043:15841318:195295014,275,+
870,chrX,15841267,15841494,chrX:15841267:15841494:195295015,227,-
871,chrX,39911333,39911588,chrX:39911333:39911588:195295234,255,-
872,chrX,39911533,39911802,chrX:39911533:39911802:195295235,269,+
873,chrX,39913110,39913351,chrX:39913110:39913351:195295236,241,-
874,chrX,39913296,39913537,chrX:39913296:39913537:195295237,241,+
875,chrX,39913482,39913721,chrX:39913482:39913721:195295238,239,-
876,chrX,39914588,39914849,chrX:39914588:39914849:195295239,261,-
877,chrX,39916379,39916630,chrX:39916379:39916630:195295240,251,-
878,chrX,39921361,39921634,chrX:39921361:39921634:195295241,273,-
879,chrX,39921581,39921828,chrX:39921581:39921828:195295242,247,+
880,chrX,39921968,39922217,chrX:39921968:39922217:195295243,249,-
881,chrX,39922160,39922433,chrX:39922160:39922433:195295244,273,+
882,chrX,39922830,39923091,chrX:39922830:39923091:195295245,261,-
883,chrX,39923040,39923281,chrX:39923040:39923281:195295246,241,+
884,chrX,39923558,39923824,chrX:39923558:39923824:195295247,266,-
885,chrX,39923770,39924019,chrX:39923770:39924019:195295248,249,+
886,chrX,39930197,39930427,chrX:39930197:39930427:195295249,230,-
887,chrX,39930373,39930630,chrX:39930373:39930630:195295250,257,+
888,chrX,39930775,39931046,chrX:39930775:39931046:195295251,271,-
889,chrX,39931479,39931704,chrX:39931479:39931704:195295252,225,-
890,chrX,39931643,39931868,chrX:39931643:39931868:195295253,225,+
891,chrX,39931807,39932033,chrX:39931807:39932033:195295254,226,-
892,chrX,39931951,39932177,chrX:39931951:39932177:195295255,226,+
893,chrX,39932119,39932345,chrX:39932119:39932345:195295256,226,-
894,chrX,39932263,39932489,chrX:39932263:39932489:195295257,226,+
895,chrX,39932407,39932633,chrX:39932407:39932633:195295258,226,-
896,chrX,39932551,39932776,chrX:39932551:39932776:195295259,225,+
897,chrX,39932721,39932946,chrX:39932721:39932946:195295260,225,-
898,chrX,39932889,39933116,chrX:39932889:39933116:195295261,227,+
899,chrX,39933031,39933256,chrX:39933031:39933256:195295262,225,-
900,chrX,39933171,39933397,chrX:39933171:39933397:195295263,226,+
901,chrX,39933345,39933573,chrX:39933345:39933573:195295264,228,-
902,chrX,39933521,39933746,chrX:39933521:39933746:195295265,225,+
903,chrX,39933693,39933920,chrX:39933693:39933920:195295266,227,-
904,chrX,39933865,39934093,chrX:39933865:39934093:195295267,228,+
905,chrX,39934041,39934268,chrX:39934041:39934268:195295268,227,-
906,chrX,39934213,39934481,chrX:39934213:39934481:195295269,268,+
907,chrX,39934427,39934686,chrX:39934427:39934686:195295270,259,-
908,chrX,39935676,39935941,chrX:39935676:39935941:195295271,265,-
909,chrX,39937066,39937333,chrX:39937066:39937333:195295272,267,-
910,chrX,44732769,44733003,chrX:44732769:44733003:195295280,234,-
911,chrX,44732949,44733197,chrX:44732949:44733197:195295281,248,+
912,chrX,44733145,44733372,chrX:44733145:44733372:195295282,227,-
913,chrX,44820460,44820723,chrX:44820460:44820723:195295283,263,-
914,chrX,44833862,44834101,chrX:44833862:44834101:195295284,239,-
915,chrX,44870173,44870443,chrX:44870173:44870443:195295285,270,-
916,chrX,44879808,44880073,chrX:44879808:44880073:195295286,265,-
917,chrX,44894145,44894404,chrX:44894145:44894404:195295287,259,-
918,chrX,44896847,44897100,chrX:44896847:44897100:195295288,253,-
919,chrX,44910921,44911196,chrX:44910921:44911196:195295289,275,-
920,chrX,44912989,44913219,chrX:44912989:44913219:195295290,230,-
921,chrX,44913165,44913410,chrX:44913165:44913410:195295291,245,+
922,chrX,44918178,44918452,chrX:44918178:44918452:195295292,274,-
923,chrX,44918394,44918637,chrX:44918394:44918637:195295293,243,+
924,chrX,44918582,44918808,chrX:44918582:44918808:195295294,226,-
925,chrX,44919226,44919495,chrX:44919226:44919495:195295295,269,-
926,chrX,44920476,44920723,chrX:44920476:44920723:195295296,247,-
927,chrX,44921767,44921996,chrX:44921767:44921996:195295297,229,-
928,chrX,44921943,44922172,chrX:44921943:44922172:195295298,229,+
929,chrX,44922632,44922877,chrX:44922632:44922877:195295299,245,-
930,chrX,44922826,44923083,chrX:44922826:44923083:195295300,257,+
931,chrX,44923028,44923254,chrX:44923028:44923254:195295301,226,-
932,chrX,44928695,44928965,chrX:44928695:44928965:195295302,270,-
933,chrX,44928909,44929178,chrX:44928909:44929178:195295303,269,+
934,chrX,44929123,44929350,chrX:44929123:44929350:195295304,227,-
935,chrX,44929295,44929536,chrX:44929295:44929536:195295305,241,+
936,chrX,44929481,44929714,chrX:44929481:44929714:195295306,233,-
937,chrX,44935897,44936124,chrX:44935897:44936124:195295307,227,-
938,chrX,44937606,44937833,chrX:44937606:44937833:195295308,227,-
939,chrX,44938288,44938529,chrX:44938288:44938529:195295309,241,-
940,chrX,44938474,44938739,chrX:44938474:44938739:195295310,265,+
941,chrX,44941788,44942045,chrX:44941788:44942045:195295311,257,-
942,chrX,44941986,44942238,chrX:44941986:44942238:195295312,252,+
943,chrX,44942672,44942937,chrX:44942672:44942937:195295313,265,-
944,chrX,44945067,44945308,chrX:44945067:44945308:195295314,241,-
945,chrX,44948943,44949190,chrX:44948943:44949190:195295315,247,-
946,chrX,44949135,44949386,chrX:44949135:44949386:195295316,251,+
947,chrX,44949929,44950161,chrX:44949929:44950161:195295317,232,-
948,chrX,44966624,44966850,chrX:44966624:44966850:195295318,226,-
949,chrX,44969283,44969546,chrX:44969283:44969546:195295319,263,-
950,chrX,44970546,44970781,chrX:44970546:44970781:195295320,235,-
951,chrX,48649471,48649742,chrX:48649471:48649742:195295369,271,-
952,chrX,48649691,48649918,chrX:48649691:48649918:195295370,227,+
953,chrX,53423362,53423601,chrX:53423362:53423601:195295382,239,-
954,chrX,53426480,53426715,chrX:53426480:53426715:195295383,235,-
955,chrX,53432397,53432658,chrX:53432397:53432658:195295384,261,-
956,chrX,53441903,53442174,chrX:53441903:53442174:195295385,271,-
957,chrX,76763798,76764072,chrX:76763798:76764072:195295436,274,-
958,chrX,76764018,76764281,chrX:76764018:76764281:195295437,263,+
959,chrX,76776850,76777083,chrX:76776850:76777083:195295438,233,-
960,chrX,76778697,76778942,chrX:76778697:76778942:195295439,245,-
961,chrX,76812887,76813112,chrX:76812887:76813112:195295440,225,-
962,chrX,76813057,76813306,chrX:76813057:76813306:195295441,249,+
963,chrX,76814047,76814282,chrX:76814047:76814282:195295442,235,-
964,chrX,76814227,76814502,chrX:76814227:76814502:195295443,275,+
965,chrX,76829598,76829841,chrX:76829598:76829841:195295444,243,-
966,chrX,76829786,76830051,chrX:76829786:76830051:195295445,265,+
967,chrX,76845271,76845520,chrX:76845271:76845520:195295446,249,-
968,chrX,76849053,76849314,chrX:76849053:76849314:195295447,261,-
969,chrX,76849259,76849524,chrX:76849259:76849524:195295448,265,+
970,chrX,76854847,76855103,chrX:76854847:76855103:195295449,256,-
971,chrX,76855041,76855266,chrX:76855041:76855266:195295450,225,+
972,chrX,76855211,76855474,chrX:76855211:76855474:195295451,263,-
973,chrX,76855870,76856141,chrX:76855870:76856141:195295452,271,-
974,chrX,76872048,76872280,chrX:76872048:76872280:195295453,232,-
975,chrX,76874167,76874411,chrX:76874167:76874411:195295454,244,-
976,chrX,76874353,76874621,chrX:76874353:76874621:195295455,268,+
977,chrX,76875824,76876099,chrX:76875824:76876099:195295456,275,-
978,chrX,76888660,76888891,chrX:76888660:76888891:195295457,231,-
979,chrX,76888836,76889111,chrX:76888836:76889111:195295458,275,+
980,chrX,76889056,76889325,chrX:76889056:76889325:195295459,269,-
981,chrX,76890054,76890295,chrX:76890054:76890295:195295460,241,-
982,chrX,76907561,76907788,chrX:76907561:76907788:195295461,227,-
983,chrX,76907733,76907958,chrX:76907733:76907958:195295462,225,+
984,chrX,76911997,76912236,chrX:76911997:76912236:195295463,239,-
985,chrX,76918828,76919099,chrX:76918828:76919099:195295464,271,-
986,chrX,76920103,76920332,chrX:76920103:76920332:195295465,229,-
987,chrX,76931688,76931913,chrX:76931688:76931913:195295466,225,-
988,chrX,76936889,76937114,chrX:76936889:76937114:195295467,225,-
989,chrX,76937059,76937284,chrX:76937059:76937284:195295468,225,+
990,chrX,76937199,76937425,chrX:76937199:76937425:195295469,226,-
991,chrX,76937335,76937561,chrX:76937335:76937561:195295470,226,+
992,chrX,76937475,76937701,chrX:76937475:76937701:195295471,226,-
993,chrX,76937639,76937864,chrX:76937639:76937864:195295472,225,+
994,chrX,76937801,76938027,chrX:76937801:76938027:195295473,226,-
995,chrX,76937943,76938168,chrX:76937943:76938168:195295474,225,+
996,chrX,76938111,76938337,chrX:76938111:76938337:195295475,226,-
997,chrX,76938251,76938477,chrX:76938251:76938477:195295476,226,+
998,chrX,76938411,76938637,chrX:76938411:76938637:195295477,226,-
999,chrX,76938547,76938772,chrX:76938547:76938772:195295478,225,+
1000,chrX,76938687,76938912,chrX:76938687:76938912:195295479,225,-
1001,chrX,76938825,76939051,chrX:76938825:76939051:195295480,226,+
1002,chrX,76938993,76939219,chrX:76938993:76939219:195295481,226,-
1003,chrX,76939161,76939387,chrX:76939161:76939387:195295482,226,+
1004,chrX,76939329,76939554,chrX:76939329:76939554:195295483,225,-
1005,chrX,76939499,76939755,chrX:76939499:76939755:195295484,256,+
1006,chrX,76939701,76939955,chrX:76939701:76939955:195295485,254,-
1007,chrX,76939901,76940140,chrX:76939901:76940140:195295486,239,+
1008,chrX,76940398,76940659,chrX:76940398:76940659:195295487,261,-
1009,chrX,76972575,76972808,chrX:76972575:76972808:195295488,233,-
1010,chrX,123156447,123156682,chrX:123156447:123156682:195295629,235,-
1011,chrX,123159657,123159910,chrX:123159657:123159910:195295630,253,-
1012,chrX,123164774,123165011,chrX:123164774:123165011:195295631,237,-
1013,chrX,123171372,123171641,chrX:123171372:123171641:195295632,269,-
1014,chrX,123176318,123176591,chrX:123176318:123176591:195295633,273,-
1015,chrX,123178971,123179210,chrX:123178971:123179210:195295634,239,-
1016,chrX,123179155,123179394,chrX:123179155:123179394:195295635,239,+
1017,chrX,123181161,123181416,chrX:123181161:123181416:195295636,255,-
1018,chrX,123182816,123183089,chrX:123182816:123183089:195295637,273,-
1019,chrX,123183997,123184236,chrX:123183997:123184236:195295638,239,-
1020,chrX,123184842,123185081,chrX:123184842:123185081:195295639,239,-
1021,chrX,123185026,123185283,chrX:123185026:123185283:195295640,257,+
1022,chrX,123189947,123190222,chrX:123189947:123190222:195295641,275,-
1023,chrX,123191607,123191882,chrX:123191607:123191882:195295642,275,-
1024,chrX,123195041,123195311,chrX:123195041:123195311:195295643,270,-
1025,chrX,123195568,123195819,chrX:123195568:123195819:195295644,251,-
1026,chrX,123196717,123196979,chrX:123196717:123196979:195295645,262,-
1027,chrX,123196919,123197190,chrX:123196919:123197190:195295646,271,+
1028,chrX,123197649,123197906,chrX:123197649:123197906:195295647,257,-
1029,chrX,123197851,123198108,chrX:123197851:123198108:195295648,257,+
1030,chrX,123199681,123199931,chrX:123199681:123199931:195295649,250,-
1031,chrX,123199875,123200128,chrX:123199875:123200128:195295650,253,+
1032,chrX,123200073,123200307,chrX:123200073:123200307:195295651,234,-
1033,chrX,123200253,123200524,chrX:123200253:123200524:195295652,271,+
1034,chrX,123202341,123202616,chrX:123202341:123202616:195295653,275,-
1035,chrX,123204956,123205190,chrX:123204956:123205190:195295654,234,-
1036,chrX,123205134,123205381,chrX:123205134:123205381:195295655,247,+
1037,chrX,123210151,123210404,chrX:123210151:123210404:195295656,253,-
1038,chrX,123211754,123211997,chrX:123211754:123211997:195295657,243,-
1039,chrX,123215197,123215464,chrX:123215197:123215464:195295658,267,-
1040,chrX,123217164,123217411,chrX:123217164:123217411:195295659,247,-
1041,chrX,123217352,123217623,chrX:123217352:123217623:195295660,271,+
1042,chrX,123220366,123220628,chrX:123220366:123220628:195295661,262,-
1043,chrX,123220574,123220809,chrX:123220574:123220809:195295662,235,+
1044,chrX,123224392,123224617,chrX:123224392:123224617:195295663,225,-
1045,chrX,123224560,123224825,chrX:123224560:123224825:195295664,265,+
1046,chrX,123224770,123225033,chrX:123224770:123225033:195295665,263,-
1047,chrX,123227827,123228102,chrX:123227827:123228102:195295666,275,-
1048,chrX,123229183,123229428,chrX:123229183:123229428:195295667,245,-
1049,chrX,123234393,123234622,chrX:123234393:123234622:195295668,229,-
1050,chrX,133511617,133511865,chrX:133511617:133511865:195295690,248,-
1051,chrX,133511809,133512084,chrX:133511809:133512084:195295691,275,+
1052,chrX,133512027,133512290,chrX:133512027:133512290:195295692,263,-
1053,chrX,133527440,133527665,chrX:133527440:133527665:195295693,225,-
1054,chrX,133527610,133527883,chrX:133527610:133527883:195295694,273,+
1055,chrX,133527828,133528099,chrX:133527828:133528099:195295695,271,-
1056,chrX,133547485,133547727,chrX:133547485:133547727:195295696,242,-
1057,chrX,133547665,133547901,chrX:133547665:133547901:195295697,236,+
1058,chrX,133547847,133548072,chrX:133547847:133548072:195295698,225,-
1059,chrX,133549013,133549272,chrX:133549013:133549272:195295699,259,-
1060,chrX,133549215,133549486,chrX:133549215:133549486:195295700,271,+
1061,chrX,133551164,133551429,chrX:133551164:133551429:195295701,265,-
1062,chrX,133559198,133559441,chrX:133559198:133559441:195295702,243,-
